 NNS NNS NN | VBZ RB VB IN NN.
 RB VBG IN NN IN JJ NN IN NNS | VB TO VB VBG IN NN.
 VBD IN DT NN | IN NNS VBP VBN IN DT NN.
 VBN NN NN | VBN.
 VBD DT NN TO VB PRP$ NN VBP PRP$ | PRP VBZ PRP RB.
 VBN NN WRB PRP VBD TO VB | PRP VBD DT JJ NN.
 NN NN | VBN.
 NN VBZ PRP$ NNS VBP JJ CC VBZ PRP VBD DT NN IN NNS | NN RB VB TO VB DT NN IN PRP$ NN.
 VBD DT NN IN DT NN | VBN PRP TO DT NN.
 VBN TO VB RB IN NN | VBD VBN IN.
 VBD IN IN NNS CC NN | IN DT JJ NN.
 NN VBD CD NNS | RB VBD CD.
 VBD RB VB IN NN NN VBD NN | MD VB JJ NN NN.
 VBN IN DT NN | VBD WP NN VBD TO VB.
 VBN DT NN IN DT JJ NN | NN VBD TO VB.
 VBD RB IN NN IN NN IN NN | VBD RB VB PRP RP.
 VBD DT JJ NN TO DT NN | NN VBD PRP VBD JJ JJ.
 VB DT JJ NN | PRP VBZ DT NN NN.
 VBN NN | VBN RP JJ VBP DT JJS.
 VBD DT NN IN NNS | VBD DT JJ NN IN DT NN.
 NNS MD RB VB | PRP VBZ RB DT IN NNS.
 NN NNS IN VBG DT JJ NN | VBD RB VB VB IN PRP.
 VBD DT CD NN NN NN | VBD CD.
 VBD DT NN TO VB DT NN IN | PRP VBD RP.
 VBD PRP$ NN IN DT NN | RB VBZ.
 RB JJ NN IN CD NNS | DT NNS.
 VB NN TO DT NN NN | PRP VBD PRP DT NN RB.
 VBD RB VB PRP$ NNS | RB VBD JJ.
 NN NN VBZ IN NNS | NNS PRP IN NN.
 VBN IN JJ NN | VBD RB VB TO VB IN NN.
 VBD RB VB DT NN IN DT NN | NN VBZ IN DT NN.
 VBD DT NN | VBD CD RB.
 VBN IN NN NN IN DT NN | VBD DT NN.
 VBN DT JJ NN | IN VBG CC VBG PRP.
 VBD VB | DT NNS VBD IN.
 RB VBN NN IN NN IN DT NN NN RB IN | JJ NN VBD.
 NN VBD JJ NN IN JJ VBD DT JJ NN | RB CD NNS IN JJ NN.
 VBD JJ VBN IN NN | RB IN JJ NN.
 VBN PRP$ NN | CC PRP VBD.
 VBN PRP$ NN CD NNS RB | RB DT JJ NN.
 NNS TO VB NN | RB VBD RP IN NN.
 VBD RP DT NNS | VBD RB VB IN NN IN VBG TO PRP$ NN.
 NN NN RB VBD CD NN VBD | CD VBD.
 VBD RP NNS IN DT NN | IN CD NN.
 NN VBZ IN NN | NN VBP RB VBG NN.
 VBN NN VBD JJ | PRP VBZ JJ.
 VBZ NN | NN NNS.
 NNS TO VB NN | VBN RP TO VB IN DT JJ NN.
 VBN NNS | RB DT NN NNS.
 NNS TO DT JJ NN | RB NNS NNS.
 VB TO VB DT NN | JJ NN IN JJ NN.
 NN VBD | VBN NN NN CC NN TO VB PRP PRP IN CD.
 VB RP IN NN NN | VBD RB RB CC VBD NN.
 NN VBZ RP IN PRP CD NNS IN VBG IN NN | DT NN NNS JJ IN PRP VBZ PRP PRP$ NN.
 NN NN IN DT NN TO VB PRP VB RP RBR | VBN.
 TO VB JJ | RB RB.
 RB NN VBD IN DT NN | VBG NN RB VBZ.
 JJ NN POS NN VBD WP VBZ RP NN | PRP$ NN VBD JJ.
 JJ NN NNS IN NN | RB VBN PRP$ NN.
 NNS VBN IN NNS | PRP VBD PRP CD.
 VB DT NN | NN VBD RB IN.
 VBD TO NN NN | RB VBN NN NNS.
 VBD CD NNS IN NN | VB RP CD.
 RB TO VB | NN VBD RB RBR.
 NNS VBP IN NN | RB DT JJ NN.
 RB CD | DT VBP.
 JJ NN IN NN | CD JJ NNS.
 VB JJ IN NN | CD NN NN.
 VBD TO VB NN IN PRP$ NN | PRP VBD IN NN.
 NNS NN NN | NN VBZ RB VB.
 NNS VBP NN | DT NNS.
 NNS TO VB VB | RB NNS TO VB NN IN NN.
 JJ NN VBG IN NN | VBZ RP JJ.
 VBZ VBD TO JJ NN | DT JJ NN.
 JJ NN IN NN | RB CD IN DT NN.
 NNS NN | VBZ CC RB RB IN JJ VBP IN NN.
 RB NN | NN IN.
 VBD CD NNS | VBD RB VB.
 NNS VBP | IN CD JJ NN.
 VBG DT NN | NN TO VB.
 VBD DT NN | VBZ RB VB NN.
 VBD NN IN NN | NN NN.
 VBD TO VB NN | VBD DT NN.
 VBD JJ NNS IN DT NN | NN CC NN NN NNP NN VBP IN DT NN RB VBN RP.
 NN RP IN DT NN IN DT NN | CD NNS.
 NN DT NN | NN IN DT NN NNS.
 VB DT JJ NN | PRP VBZ PDT DT NN NN.
 VBD PRP$ NN | NN NN IN.
 NN VBD PRP$ JJ | VBD PRP RP.
 VBD NN JJ IN JJ | NN VBD.
 NNS CD NN NN | NNS RP CD.
 VBN NNS | RB VBD.
 VBD DT NN | VBN JJ NN JJ NN.
 NNS NN | NN NNS.
 VB TO VB DT NN | NN IN JJ NN.
 RB CD NN | DT VBP.
 NNS VBP | NNS VBP.
 VBN IN NN | VBN WRB.
 VBZ VB | NNS CD.
 VBN JJ NN | NNS.
 NNS IN JJ NN | DT NN VBD.
 CD NN VBD | NN NNS.
 NNS VBP IN NN | RB JJ NN.
 NN TO VB NN | VBN RP IN JJ NN.
 VBN IN IN RB VBG NN | VBD RB JJ.
 NN NNP NN NN | NN NN.
 NN IN | DT NN IN JJ NN VBZ IN PRP.
 RB JJ JJ NN IN NNS | NN NN RP.
 VBD NNS NN | NN NNP NN NN JJ.
